sgshivnungessliq: ugliness
rhygzrhbaepotpcr: copt
bgooalsuaanednre: bog
aophsripceatrcgs: spectrographic
hnptxerdibpeoeme: biped
rwrhsoatlrtgiadf: harrows
rnzlctalebtkveoe: evoke
iltodfsgbiinfaai: big
mtnrhreppgveandu: vegan
sithdoziltismjpa: limits
saoserbrniriortt: borers
icuomahtisnmingi: mustachio
tixgqapeolloegos: goole
fshmtoprdootwipv: droop
izipmpmfzrelresa: pimp
psuumanulusrlcou: alumnus
tmioacnncadtdeae: canonic
ienoatfinxsuiwtc: fenatio
dzitnhbaluoiroyl: zit
mspuereetdnszsas: presume
nnkiolsnbuayococ: bayou
miivicpspasteilf: sappiest
rohphlptditiasns: saints
vtieohitsluodany: outlandish
necnebcantnwulgo: banc
dreppqetptaivzic: prep
tecgrnuhkcvhoecv: chekhov
jvneyepntesxlzii: stepney
lhwptyeballancai: batley
onepatrisrtnoaol: terrapins
faliesoettprqbrs: potteries
bknjoocergfuglai: fugal
ilgttngipnriaiis: printing
hriorippaciaknet: aitken
manuecmtiepoxdpc: acumen
efsmnxtiiriogdra: drag
ixsnnaerncltgtwo: central
osrtftauayisillc: fatua
yhvchydniodamruy: diamond
gtgcsrsranegyliw: yearlings
pbtoriaryhyfcpgh: orbit
zusllbisafeontop: bulls
oaprhplnricoyagl: pornographically
sjaemzimicronsso: crimsons
tsreonusanuugcsi: tonsures
smkpnootitciiayl: option
nsesbiippndylwaf: flaw
ntgeeirbenrdebip: biped
edfsynilelbnizmf: belli
ltehioppnranguxz: hornpipe
ceitfelnfaziyoat: fecit
caeitntnarlsiczo: intent
uleilsycnahbfieb: saliency
bflpthoasreehysj: pashto
ezowsdufsrpoopir: proprio
isdnteudhoisgiun: hideouts
mdamyedcerxreonx: eyam
atinvegsnaimsebi: vintages
votclaxunnitwria: octal
cpddetiainresiaa: daintier
ogotapipilhzrnxs: philip
nipzdesebrutrsnk: trunks
cogscplrxiototks: prolix
trnpeareabrctalu: cabaret
eixaegdnneatorxr: aged
inaosuifzbditlsk: kilts
pdgyeaozxhiermme: edgy
ortprtiieneeartn: reinterpretation
selsduaseznsttnl: lauds
twokariijcednngt: wok
sgrasgteisnhtnss: straightens
hteacnzyesreitao: eyries
coeatlopbpgshsrr: potable
eoesscsdyekpsdiu: pesky
gigefdnnlhusidmi: fending
nngorqercgsoueru: scourge
lpqngfaiisrsdsem: fang
edcgowlaewxirhih: aglow
nnnceiootetfoarp: cootie
iagprnmglruogrem: paring
usbytpgitalobaur: labour
dianmnedshdgnrci: sandmen
dinuimrnscodptre: indium
epesominhvarsgiz: overemphasising
aatllrkpmkgiazyc: kg
seviggssrensaene: aggressiveness
nionmsehimtpgevr: homines
hrjttpisopaeaosr: apposite
zvhoaoaelcisvfck: vocalise
nceefskrdhaiusni: fences
utukiortndmlilna: mild
ndeeericroimuact: corium
etcainrlvziyimnb: clarinet
svepredrbcennopa: vesper
ilekpnydsmaczmet: kelp
ssnctorsijampthi: majoris
elsemdirnayemotf: dairymen
yhztiiarhilingni: lignin
gspverautoohrxio: photogravures
tenseleensesssss: senselessness
attqgnggfclaiuin: lucia
eitprsceoclftuke: receipts
imomadoeszrnpeue: dozes
nisdgexpesaroneu: europeans
anoseykeitsscmru: sickest
dreteiurbrtsstip: erudite
nvnotcuhdugesroi: drogues
scrgrieserroevtx: overexerts
gsgrtsdniaaelidn: tragedians
wzindtaongregglc: donating
vtitcisaaneactpe: incapacitates
ebaydtcisrbisace: ascribes
entoriseieszctut: seizes
oasrensoicmgfljn: comings
cnlbuquafvgoryiy: fuqua
amprecdhneshdipe: cramped
scaertsoielyplco: stereoscopically
shoatfmeflcrreuh: fathoms
drciljlgascsteyk: ecstasy
bintiutseilfcpys: sulfite
arnqilaittodiuzn: zuni
nydaiirmzeltaloo: andy
dltlsszcuhyrievi: rive
pahhsncsriiapzld: narcissi
kliomkxnsrsketpa: kept
ajaseoisgrtrpndp: goiters
eaqlnifeolushgcn: cloughs
riesoobigstuitdr: boogies
lnpirslgoimuisny: sligo
mporanstomioiedn: modernisation
intaaensrcnyigio: crying
ieedssdseointirg: disorients
udjtaelmbcumnlca: becalm
exetnnudpestnrei: superintendent
eitnseiarnsvvtzs: vervains
hcgrmgoarnlootig: looting
kjcneslialwvesol: vowels
ibrvuckrcnbbegne: ruck
moyientgterijtcn: jitter
meotvnilrsndynev: violent
aerievrimzolxpdm: lox
smesnmmbtlehisat: thimbles
awutrtdpdhsisxac: axis
ynomgmarlciunsbe: incurables
nealmiosataiitjr: anomalies
iornlecpetrasomy: percolates
viugnortsaacicrm: circumnavigators
ualtrtlioonsilst: littoral
fsnqcciteeilayku: kay
grinpivojnsbdere: benders
isstismkntviwiee: minks
decpniuanlxnotef: pecunia
nuggocgrintavoge: cavorting
aanisncdinpisilr: insipid
itraipyckolgplat: picky
eiirmosnfatgrfis: informs
ilsciowacntooclr: control
owxttispaonmamei: maintops
ltsirtopgiuopysc: coypus
lnfpcytituaiwosn: city
awhtviuediddiine: dieu
easpersniddzevht: rapidness
ionesatsvnloeinc: conventionalises
teoehrlasgsuuhps: slaughterhouse
spnoredurleshhti: pounder
icnmwerigeaykdtn: kay
elrvwiszpdrayoet: parody
bloisktsndyiiilu: kilos
vidiiinmunmqestu: quest
trugkntiemnyiolk: gunk
ravuienludnvzgne: unlined
klebsaludeninscn: unlined
litscoaspyeecrlo: stereoscopically
ticynnleivcoaiib: inconceivability
irisustitsqnbcpo: sirius
mstexdrppouyusul: prop
iapucaiztlenedrd: undercapitalized
laranotuamhirtis: mahout
zzruagnkoflioipp: folk
itygncrunqiylgie: tying
dgrecroxpvnpguoi: grocer
mdoaetruumclaibp: claim
eussitncnticnjeo: instincts
eqtasanliirlrlhu: qantas
orncliasziunmess: aluminizes
sunnetilssouaita: lousiest
sigyeppttontheot: phototypesetting
usdecosernceerfc: crescendos
sepllisgzcnpozek: pills
msreweomwasllmha: mallows
lkqlofuhuliylnes: lysine
ncinterigdoonrzn: crediting
dsifriuetsfonsas: stuffier
luwdlnnrkaessufe: ukases
tirestlusqqvoitn: sultriest
rjdyissgnieliang: ensilaging
stnautoiiinwncod: unitisation
ginzooarliantaxo: organizational
taettletdbengmmm: belted
mitluscasjeaceci: simulcast
rsaiilstiduenerd: reindustrialised
riuoahcmolyswngi: swingy
oalialhmatusttcy: thalamus
itdimringnaicrsc: craning
mtvcdianmerenoio: remained
shprmaahnebreigo: bernie
peniguinesiroanf: genius
oaltkiiceurfipse: talk
raybclwppuoayhan: pup
ntacwtoascisleln: oscillates
orgniasnrmtisfgy: martinis
asyllzodeldcrhti: coddler
bceclrtgtialiaoo: gait
gxueirvndaacerrk: advance
atirpsyumaecssgi: supremacy
kitojrmrhbcopvho: kit
efioruxgnnnzicgr: roux
rbpoyblitasipqro: bop
espmmduhyestaoro: yeast
pifcyallcuxfoeis: pacify
hrcteittyoaolani: toyota
initqacngezarimy: gazer
asivemrphaesaeor: vampires
edmtfctkcifnnsia: tick
eeatnqrgubrteigs: begirt
nvuymspgiesweisr: pygmies
endtllaouvyleepm: levy
edsmiednhmtkoraa: demised
aaxyilipddiebltn: lipid
mtoerrtrtcniejsl: injects
geismtggemnarxrc: gagmen
silnualgqsaqpyvo: squalling
kadeclttfnipgonm: tackled
sogiyauotpedumsn: stumped
onmanuodcimxissc: annum
ghsejegtnesnsotr: genets
ecaelrripdplyknu: clearer
rzsgngipnidaeelo: pinging
dtdantjsxrsuietc: cestui
rccsjaritmceaith: arithmetic
umesisouynsabiog: bonsai
xrlprhcleyyloaib: hyperbolically
eslcnhtgtryabsih: brays
xoeoplaeftissprr: fiestas
msssifbvedslseja: fibs
ioieebhserrfdvjd: herbs
nnzbeganteoinlfo: negation
ooainctrixnticoc: action
ntnaenspgrkuaivu: pennants
yiovndnoteulocvl: convoluted
agnietinarlrutts: retaining
moiheibvcradqssf: vibe
mvnamouidelgrxis: guilder
tclvrelzkiodicef: coifed
asetwurnfsoejapl: jape
dptcnaraceymomot: creamy
atrgccmripohmaoh: morphia
ommrnslisilidrea: disraeli
sdeehfagostrmein: fagots
tekhekfnsdtgnreo: goner
mjignfcnyimirfos: jig
ytrraeernfedsdgm: defenders
ctasuqsmioimsagr: squats
aeaziuotilmsxncq: ultimo
ydluieatkrclnire: tackler
enzosinyglpriuqf: plying
tfsephskrbktoret: kb
rhbnueaeddbgefti: beaded
zharhegemdtzopri: gem
rnesycaounmlmtbi: consummately
uoiilvcpazlsysch: civil
clnprouenxabieeo: pour
repfrakieelttebn: leakier
ebglponqhriyitqz: beg
hpnohpeyrqssecso: phoney
crsotuninfekolmr: menfolk
kluesrrboeatmeaa: troublemakers
dnczsproescneore: corpses
udztraehraiemycc: tzar
lneucojtnnvdinoa: jounce
dipssvoeecrlapei: percale
urbnlneceoeboadp: abode
psaeainsthlsssfe: faithlessness
ruitbebveeadanva: tubbier
ianttedrocdoeiin: detraction
euumeipnrnmvrgts: ripen
gntitaemawnorrlu: narrow
trmheipltyavelsu: suavely
dnerntxrmasagier: marriages
oeictcnloaylregz: geocentrically
roajtdupliyncmce: pliny
oemaxogqllrnyioc: amex
socsmehgqqrpasyi: prays
goeyruelxbdgngih: luxe
ivtecilaeprrdoza: replicate
trsiocuwezzrhgba: curios
brinaospiiadatsg: baronis
tielaongwssrqtee: legation
sitiolutvepndmso: outlive
enbltmiiidatryes: determinability
orheinctgzcraira: characterizing
ioansoxlyfnoetrd: felony
iokpitosectarsjn: pokiest
todpnrfaioleilma: infra
rasbioutnitlaiec: tribulations
eumnqcreamwsqtei: maws
jiaslnrgpairseyp: sparring
tegieqdefavrwfrr: deaf
iledaytccoxiallw: oxalic
rtdvepsyiigcidle: yips
oxmtarkonrcioprs: akron
ailrortfancsmiop: maniocs
tibntsemseadilhs: disestablishment
oietilpfrotnpang: flip
hnrapfrsuegesrcx: refuges
yieaolpervxpzert: overleap
ytpterahatpmseos: apothems
egyligallcaltzis: glacial
gnnisdusnoseuese: sounds
nrmiiryamflalyus: familiarly
raipiixyftopbtbl: toxify
yiuilitetorsnpsb: portents
detahodepdietjrr: doped
unaoiyltltainern: internationally
trdbaiurtufyilie: fruity
pnsossineeitadwp: waited
oinegrrsndeirect: renderings
niinsntttyievssi: ives
nuotnlgysasosutl: slangy
msocpbtaseosinur: neurosis
snhizdqnadusotef: fadeouts
inttalsalartinnc: atlantis
ttiurcdnieoeslbe: codeine
nrpmewtooehsqlav: perm
ainntglreesnciez: relenting
izliggrvpnsentin: tenpins
apesqvensnifhsxe: finns
afkztlmniazrioao: moralization
asdcnaicellkanai: alkaline
xesnabltaiprcosm: tropical
ijimunqeeisnatdo: equines
yespwltterfjslfo: pews
tpmcnishipsrepae: sapphires
ehtcvmmislrsasio: sailors
yldfandndsfiaiul: disdainful
siseertoyrblpznh: reties
izzuiinfvgravilt: vital
icpmyantenoaiomt: payment
itnohaecuvericrt: curve
tblskylqpueaeign: equipage
tsdiaewazrujiiln: adits
khiefbeserromgep: freebies
izceonaudcflmsin: cozen
nriganefxkrrtsda: fearing
cicnmheiawytsspa: machine
ssopzemesssdagis: gads
iottngposcodarrj: potting
qlbnihssyicineit: incite
memgtngthsirolet: ghostlier
rtiexnyuooeseckf: exit
tdtrllaayicinbti: racially
neltiivaoaptnxxs: inviolate
kcssrllaiyqtcess: kc
saomnucmonitrfic: consummation
tnsecusupousisai: census
ofitegocolidlnrn: decontrolling
uhtiraewcnndnahm: carew
tocoygovijclails: lilacs
ntteenenwimteiir: entente
uppyaplazaeghvro: apply
toabwizisymoknsl: smoky
ialmriiwtyidsrst: tidy
ccwtlmiahlasjsiy: halimas
syastrrlaceililu: surrealistically
cuolyrgsovpgimdi: glory
oexiraoptssbptrr: pastors
itsoinrtnararfug: transition
tenuuhsjusarepdi: upraised
atfoilduiistsnnt: foil
flicfincltesyali: scientifically
rseeeiehiiltrsmc: msc
otiuusrsmnlsjcyr: cry
iflsailogtilpiee: flails
uyuiieocnspmsvol: ponces
tznenecmadoudnnf: menaced
arxyprcbloikhear: kilo
nnlejpcimwetxmgo: jp
msgrviegareitcco: categoric
rdtnrfeanwdxceia: fawned
fuesilxylrotdeeq: retold
mopsaovyantnlule: savoy
retgwceucircsoap: prosaic
ypricaeagholpvak: paleographic
iocdtinnatmonahe: diction
rperldntsyatorfz: transportedly
tpuioaiprrtrpaos: utopia
ctieeaoufnaftacv: caftan
ssuaeevcnirpsonr: provinces
ustoirlikevxztno: kiev
aetcebuetolnacdz: cuttlebone
taoeizuhagiapnso: soaping
fodiihpntigxltsg: pint
ntotitcxoeyhhsup: exotic
vrosnispeolcatre: processional
zshptblpseeaaiwa: baseplate
aiinyfbprrlvrsee: levers
tiertihtwyvoawau: avow
eeeuontknlvcocis: knot
yopmesoabnrsetrl: bemoans
rzuaietnsepevdal: azurite
yagnbghweliwitca: while
njsfliotqvtisoeu: soviet
srrtmiowbseiisfu: bowies
norsshisetaleecn: enlace
tqgesnecalotgerm: colgate
rehndtuazrgggsda: unthread
igeexrsroredusvt: devours
clzpdtivgnaaypii: vagina
cyvetsieirpefmrl: petrifies
imsceecqdrsendeo: endorsed
igonimbeerntatrz: entrebat
hnmceodiiifuiatd: dehumidification
etacagtnozqkoiri: tango
aoiutyxrvelicnst: clients
lsedznboesssnucg: bonzes
citltrioeaarchjb: retaliator
elcotnwdgdqsokea: qdos
wazflbdiierzonot: birdie
nueecscsnuufslss: unsuccessfulness
iomitjsfnuaaliqc: faunas
adpbdbireoemnttl: bribed
narmowmkpheipgde: kph
ibiilelisntstyag: stagy
meikraonncunmdts: mike
aectrbiohovvorrk: orbit
abwpmgmarlerjtom: margl
fflsjnunawelwuss: wale
aesoslxeionursvm: verminous
sbtesessglmnraae: besets
dstieaasnkprhaex: pranks
apdenrgurnmrodmm: pranged
fghndugtoliloioh: dung
irtnpipryaenatsn: peasantry
priaigootdcelelp: celled
ehzhtisdzidyqope: yid
trhwptsoeadoidze: estop
escroveinesbptea: corvees
istwagineeonullw: sweating
rdietnensetsgjru: interned
dscpuaestoioshae: outpaces
eecroixdpniexnie: pined
eacamtlqdmisrbmo: calmat
qpeerxveostunchm: vortexes
seecysvppcrlxdoi: pc
abuonotsiitsjiyl: jointists
gjisilivtrsedain: trivialised
lliwtcdaoalyceei: wildcat
lbcirvrtejanteoy: janet
critizoatldrynoc: corny
lbieceliapaytrnx: planarity
rniebeclaolarntc: cable
ioislseroarercts: arteriosclerosis
casirtuivevoornn: virtue
llytifvaundaoetc: uncoated
antilivbwydlalem: dally
etnnsioxsiapincc: expansionist
oentnnnepcimssgp: epic
nseoresifipsswxt: personifies
spbiknluuncooycs: blink
preemudnreepntcr: percent
eraiatzdlfyemrns: fly
ofrunnoolaitntfc: flotation
eionnntdymjaniag: again
udgsrabtahtrodgw: gradus
nixaltisytieihub: inexhaustibility
ncrpwnlazeotsevu: zealots
iinynesptozrodti: pontes
tiorxnsetnyainau: yentas
nizicosaoifftads: distaff
inevpcdttpedarli: prattled
yalnurxradscbato: broadcast
idyhisixnngbiigt: gibing
tlnrcsmqatipieta: taipei
evotioaitindxfoc: fox
tgperrmmdehroacd: chador
eabdtsdairrtbaru: basted
dosstiysiatmbilp: blimp
nmypitratrielpne: interplea
ibrsnamragebsrti: bargeman
thmroamdpohsiree: dimorphs
inpoengjsrrxmtia: opening
lkznetycnrotciic: concentricity
nerpoeutzeusitnt: pouter
ssaiojrobncepolx: brecon
jtdfsrrehghieuro: higher
iernrtoncggyueqv: guy
veelqslwsfssnevs: qls
anbpyyorumeptesl: permutes
mlbfysuritwieaal: waite
dwiissrtdtpuuebn: put
otezfnrmaltaaiii: fez
ncoricekcuntetgh: cockier
tlfunorltsoingul: tousling
bysgellbtirghmin: billet
ilenronsdbveyssl: bevy
essofoncrtuusfre: fructus
asenltrienrsnrit: entrails
oecpxarxfsrtbria: praecox
riuolycatstafisn: unsatisfactorily
sasaeupnuotvletx: volunte
sseeestnslmashht: nestles
aimeentgsenrlrxx: geminates
tdzieiernaepsqsp: pedestrianize
equctrsleitacyla: crystallite
sitrvoecewtjrpoe: evictors
utuainciytsiohfm: city
mepsinotrckisiod: inceptors
tdnfiidteioaeinr: find
drralgetaitnnist: transliterating
aaunirncicoimtvg: circumnavigation
unztgohagvrsicyw: gravis
iyantlnteevhwerh: litany
wfxoaeiriismrltn: fox
peglvnsfisnyiadc: peg
orofanncitehntcu: ancient
anstnimmvatusxsi: mints
cnaprqiuutckusts: stuck
paetemcrzesagnhl: gazers
astrtoirlhogcean: traitors
tutniyoiarlwlnan: unity
iuaeantpriqixpng: painter
degizapelnnvnuur: paz
nunmmgstaisptisr: summating
otsylrmuuybacrni: buy
ifvaiqtllthuayqe: quay
zvlloulnmiugialt: mullion
oanpspteriqblhuy: reappoints
hiphrguesooprfat: prorogues
yaliinebcncvoiit: inconceivability
ziiaqqlnutinaotr: lunation
bnttferckeiaeaio: creek
naipotogrtztinas: grotto
oseftucidtanmdej: foetus
lneatbrcsuenpoac: pounces
aovlialcdyynaerm: acidly
pntnlirazdouatic: lizard
gacbloeliucatnfn: inoculate
wreydjyrunpersti: penury
taepcinclostrdne: capite
yritlianivasmdte: administratively
noiidtgnzhiitvan: tiding
reavrsbirksbwetx: braves
ckrrepnommasniee: misname
iznaimdaeslmirvg: dilemmas
iotaodaircncnnti: contraindication
isyhejsodbnnsiet: joshed
txrfwdenosiaromo: frowned
tlamyniilsuaoccs: mainly
zscbiailretopgot: irascible
aureamtiscnsictt: circumstantiates
iincsosqoagatrsv: scions
girntyaslcitnsil: straying
duursopoyulsphhf: hyposulphurous
soamelmiirdutlik: delirium
sanlaiwnttyuilor: nutty
sosicvsneuiranea: vicariousness
oanagsirmtviitnu: migrants
coiebessinthsusz: obscenities
ndtvrstialnaemil: translative
sbmanmaouancgitl: guanaco
ruszmroeattreonj: rotten
runytrsqsaeaolvs: loaves
upnbyedlnatusraa: superabundantly
eidcervkssepmrin: primness
orrewnessrsgtssa: renews
epfabgddisrpaicn: rapids
zsazpgodkdrainep: zaps
knlaabgeynfmuiki: balkan
saotsuvaorvntiln: savour
lebysaealgveorip: savagely
rnydsiathbihttoi: habits
mshdsegpaeanefdi: gasped
cedeisnfnfetbnib: defines
tmranettsuemccno: tumescent
ttdtitjenuiuaois: june
fighiryiotanbhdz: obtain
mmomrrpgshstaphe: paths
oitetemmgpanbirn: pang
serefgltaorfedpp: flotage
tnesczrntvruoeoh: overturn
ciesmognivcfltil: moving
yaxoghbktiltossn: tonsils
nsartasainsowjis: artisans
opfunmtabgmnsirr: pouf
shecqaxudhedaezr: razed
aniorcmmmeosotca: commemorations
eneecomniuntngrr: turning
hgtasnezaletseag: eaglets
inoaejagbolcrtfn: glob
annigucyhlopnlmi: holy
tjsllnisnatecoon: isooctane
pauiysflmniriplt: flimsy
oidtamymslsgiled: glides
hsrnwldsnoneefus: fuse
eileyocawlvtvcit: claw
fisfrtcsevtgtlsh: first
eicqzitmairyslti: riyals
hsnguqinhivhrlie: gnus
whraexetmdozdicc: extrema
oadccmuimonntmil: omnium
ctrsicsvharpeeam: ampere
aniqtxiasaloaptp: laptop
yriuqluuvsbrotii: bistro
lilarytowmplqnon: artily
xiesgrleernblaro: labor
nstxenssgareueco: gressane
apinsiridcetraac: indicters
poaicktrovpcuefn: trick
izauaidimqnexntn: next
noicjrnramithiev: antrim
avntaynnalstbvir: blast
rrmeraneipclliyi: repairmen
rqirrsefketkbrea: baker
vcpatoulbmefeznt: computable
ilucaoeitacosgzl: lucia
eloltrhssisneeev: toller
nkmdttsorandeenu: undemonstrated
irnculigthnqnesi: curling
txnoushicxgipomy: cushion
dnlivtcrsalysica: crystals
blapeazexeitirtc: leap
eeearrtegntnmtip: regenerate
tfaeauailscrmton: calumniators
welqijndhdtmreey: emery
gnhaznigoimyajut: hazing
ocfcnitritaoltsa: altostrati
eylbrtqaqxonthir: trebly
tpsinailsocucuyi: alpinists
onmgcivdsotncini: coming
dnvjuacecsirnaxt: accuse
rhfealugeernsets: leaguer
oetenkxxisrirmte: xix
rreeevargstipesi: pigsties
tenntixoiracqjdd: toxin
esxnltiomlciwdis: milton
tefrrriepbhenome: prier
oeprzloeypfynqpl: yep
mtevixwtidkreonr: irked
arvagospyhtorihi: toyshop
mnrmilateizfozse: militare
bisarplnoseacejs: personal
kerjuessortoctdn: jerk
tnpucipsctnrreoo: punic
baetrifmledcutaf: mulcted
tnatsliosnsiulva: avulsions
ifcbrteaqlrniexa: liner
aiutnangdideesli: undesignated
alrsneawibipmodt: answer
irngsxxheaoeutpy: xx
rptuilnrsmsaeura: supernaturalism
qiwuouusytmbiuls: musty
loiznucaoootinst: zuni
dnotsjviissiospk: jots
rsionaduipesrtse: depressurisation
ainaszshidttabro: nazis
acsnstsiphsitavs: vistas
ucppaeoanlrjprbu: burp
virrtdhkeesaiteg: ekes
surtuswoehexaleh: exhale
eingyoaomfrdurce: cruder
yiitoydoiscuflzt: sufic
cwbheayillatalim: lily
brsneisooexnccia: erosions
ildeyohcfjbqfreo: doyle
iuoshasatatioxrn: shasta
lnniidrestainhte: tarnished
gssbksheofiipytn: pity
smueberiemtrnnsq: reimbursement
dyrcclstnceenatn: canteens
edntalzaoeniidsi: denationalized
sgrnigfewenninmt: finger
emhikctnpoefraci: profane
nioumurresrpvyae: rumour
rtcvroilsebnerea: convertibles
pdeeaueoddlhzmwd: doled
tnatgarognmeknfi: mekong
ncnglbittfuvakao: glib
cpmeraoonsvareit: compare
pfidchalyrmykdon: archly
nssyliqtesivorut: vitreous
eiopyskpcsuorlfm: pucks
niluistmcvidkedj: victims
oplxshyoieripshs: hosiery
nneaumieudrmiats: immured
lsubmenpeoarymjc: busmen
cjvlaotivjyhespc: psyche
eispceastilrfuii: superficialities
xgtunesiehryuizs: unites
nfeqyafxeelmtxai: fax
rlxatdsrocbroeao: scoreboard
erhtnxremgesotks: stokes
edatkrenlruiwepx: tanker
vuofigqrensnsors: fig
yrhtiaelolalplmc: heartily
reilstnaeisrdiou: tardiness
mgprniqedseatgne: negates
bsgheclstrakcear: tacklers
soiaasrennlcylpd: ply
tadeqwetnuudeaxn: undue
ivntrqibicamayli: amicably
eaytchutjnnssigi: cathy
deaeyrfgsrpgnqmr: fry
acounientdnbcesd: uncontained
dnlhiiwsegtcqout: quo
wlmfybaeuotouncr: contour
sacusulsofyibnrg: bring
amlbssiettenivuy: balms
sitrmlicpanoanat: complain
onosxtflnfasscie: flans
rtiidcsrtoedbnue: debtors
utmhfrcrqaaoolgm: gloom
omenuemtoairdiap: mediator
dhiolutayieomgnc: layout
ioalismuniensbdt: aluminise
ttcsvuuigbtksive: skive
tceopdapesplzrhc: dapples
tisroicvnmtutnxo: covin
nixnoularateizot: nixon
uwrnatilwacegtsi: cagiest
nyliraibiiitvyaa: airily
iesstnhijerokegk: joker
enofeqetcbofsrml: fobs
ivngoceetocrrerk: concertgoer
oieltuscsnvicent: vincent
filtignqaeiscort: lifting
tlytoaiulnosanim: mansion
deoodlxuerdvnpee: luxe
hmpgrstceanireao: cinematographers
kedayetlyongnree: leyton
seaeenrpvoelpnok: plonk
eoaartakrctipipx: patrick
mlmliriaeuiltion: multimillionaire
ismbroawosehvpbi: brims
tlseneuuglipioso: unglue
vroseuietonhpnmr: overs
xqcarcbpdlbeeset: pebbled
bvtolituntrsocre: interlocutors
udrbomicateancnp: morbid
oetpaagrtixnflgs: gratia
aoflniattsguimiu: stimulating
ccnleoeicfivntts: clone
lecinmryeisnlynt: mcneil
rsotsceashounsqi: housecoats
cmhiqnzftyailnge: faintly
yvwredtalivnebmi: bivalent
tncuniraamdntoee: tamarind
nzlncletylenuiba: nubile
apiinirpagdctejt: predicating
aciislamigtmcnii: islamic
usvectsionprrobi: oversubscription
tzonrieppnisocad: spondaic
iitngvlnivbiciny: invincibly
ysimutanoxracfii: tsunami
aeltcsiilylcasec: ecclesiastically
nnatacugrheiiott: rug
niedscmrooeanisc: monocracies
kwhdufetnredikhg: tinkered
natitmirzsnodile: oiled
cssrilutwnotgkxc: kg
aauinlqnbyeofhet: ebony
iucauptdledcnyka: yank
oleyqhldranaccii: circadian
tltacuaniylilasr: naturalistically
uojliiheuniadtbt: dubitante
fnertsigckvgrsae: cresting
zenotmmrsaemviet: manometers
hhrcshreeadgtnto: gathered
taoevxrtmyaalirr: overtax
tcoiadnglklaebkj: loading
qrmelnnircomalyq: milacron
tonoravdlpocstnl: clops
dmnkoncnimgoastu: cognomina
sdufslrnaastzeox: stanza
aoimiansnmjfltig: insomnia
apdicagyelngtvld: legacy
tisftcoainijdein: factions
acacssbtllziulro: scabs
aptidovdkfrmeeet: divot
lqiniiidnrislgat: darlings
abaiclogoioylkgl: yolk
yniveergpxalrplh: veering
btulcyragsirinit: curtly
oodtiitbneslsrhs: bloodthirstiness
oycsnnlorcoyrcth: synchrocyclotron
shaesrrgrbaioamn: brag
rseeslgdbiseneaa: disagreeableness
kesrmtttsasjnvii: esk
avnjligldhpreiin: gill
mnplnomeznkektuy: lemon
leelirioslzpcaev: cape
pnureifsentsuikl: superfine
epahoshgmmsgbsri: brigs
faaartidsnumnhmi: nudism
tzexixtotesnramo: anterooms
ylgeyfsedpeirssv: disperses
ronpljeaatoyrali: taylor
aioiedzntingbotl: blotting
nanepmnaesurrttu: superman
nsggojolimniraju: gongs
eyaammlrocaltlid: melodramatically
ipofvetfngpsrraa: gnps
svghnmziasgecpno: escaping
oirridpnenhgftte: pinned
aiwfgaontmlellun: waif
coniocinvntgniid: tiding
flouqcitjqicaneu: foul
ptnerungcaapietd: punter
spoaeaoymnsstlic: compassionately
itmaloifsfagirni: forisfamiliating
iaoecsslediirinm: solaces
iggmvmhbeeoraisu: aerobe
mlleesicdnenaurv: micelles
istnnmlmauoiilde: multidimensional
psopteiisorwkrus: poitiers
mnuweaeiewrtvrpi: write
oistnemoporsaytl: trypanosomes
axsnbnrleosicvec: licensor
iinddnburcgiredr: curbing
cetpapnjmnnokiod: ikon
uedietarnsnsscaa: detainers
plccpeakietmrwef: kermit
neufnvkkyvtuylel: yell
juroizsieantxact: sanitize
iaaailisrcmfetse: racialism
nesnsnesipesspxl: penises
rfrstadtocnrneei: consternated
cbrnnoeypmdcoser: eponym
cqmeblloeaunngir: guanine
iioscygoitlsheht: eoliths
eertpssccialhiry: respects
spaocqhnpqihlaiy: coq
entnembdealiysdb: absentmindedly
mbuapkpttrreseas: reassert
ryrnokeusatsuans: orkney
aaegysaauinntpre: unpartisan
etnwsmccdlilsioa: dills
ysrtehraaetjlbhy: treys
cvvetsiclloivity: cellist
cigustnihoaailnz: inhalations
trncbsaeocghpmre: beacons
rychuiopsieplnet: nipples
cdlonwseseksdnoi: doeskins
ueewpmfdrtliasib: alibis
aekzsdtmytmeyizs: etym
rinblimtmcsmoepa: epsom
itoiinrosprpgotn: props
uulinsocopyinyft: uncoils
oisislozgstesbmg: bests
iagccirttjnafonh: jan
edactshktsarnwya: scathed
mrocvoedueuntmea: undue
raramsaatsgaltua: gault
emhilnsdeeruduta: underlies
trarviprfnqsgton: tongs
eibsdiatoestnzni: antidotes
areovipcctmoeivs: motives
ejacinicstleofpi: conciliates
rbmlnoafomccuaqt: mooncalf
tancoiiesilanatr: liaise
kaioiloeepmicdlg: epidemiological
iqekhoaxbrnesgmu: borax
oemanspthredmgse: panthers
sineluoaxairgbrt: elusion
stcmsnotumehizeb: mounts
otrztapgayncoulr: yang
aocscpipruisecou: perspicacious
pmetocymanlnirmu: manly
iuvaniainldlotmt: inlaid
ojvuresastdusnen: stunned
ntwiespeehssrlos: weepiest
snrupuecinsosiac: puce
iinpltrpiacleisc: particle
ohimidsrtoaanneg: droits
mortnclucciituos: cul
resljpcytdecgivi: jp
mamasdpshioblars: abolish
surilytaoltnuenm: totally
oglpbahiaauicotr: autobiographical
fefsriemunetvtsn: mutineers
tsubtewusrerrpru: buttes
soolaalifttnrmix: fail
lziehaqaenqarjdu: liz
sprttiicpentqooh: incept
crattsdnseznsoen: zones
rnieenfircghxbxe: refine
anpmeetnpruyitoo: punitory
yareonirgteilvtv: interrogatively
cstoniaeivaimrna: noviciates
useikleusoysibnn: luke
ejrpctinuiodpcsn: tunic
suursrsteproeeoh: porters
ionvipbiishttsor: troths
optlhyrarsydohee: drays
ditcafzrimyrllye: yell
epkjoautszclzees: zees
gdrasuenfjdessno: sugared
njcniiocenentvml: iconic
jyeussodbrglndlr: rosebuds
iehestnadiyspalt: display
cnrooiltdaeyxlph: detail
unoiandisrsgjill: jill
ivcifiotvinrueia: civi
ltildcoiajyaivrf: jay
aosemilnsculheue: semolina
itelcaleilsyascc: ecclesiastically
ceppeaosemmtosti: peep
germwienrnbeicfr: winner
peontctqsorisagr: gars
bopciagrohtarvhx: cigar
isgntsmitukniagl: multitasking
npidngilsnswhere: spindling
nruetgiodalnqply: grandiloquent
fiatctxaulanfrio: facti
ahlynslgltoityso: toys
vipdjoovylnectra: central
likecvsiesdncefs: vices
muuoslayniomontm: alimony
ygpabrsllotarhcy: gyp
fdrpanitstoaxyve: antipasto
ydmslaicibisiltt: disclaim
drciaeueodubtarz: obdurate
zelcrjfdvoanbela: abalone
rlrybempiaosvonl: beryl
lmedoramsclxibne: comrades
drleperrngaiktne: tanking
rnbezaroctsnegoi: brazen
ieoatpnvsmqrtare: opiate
sgnisceutrooizxl: countries
aempinncglobgtkt: encamping
nexadoptctrscugr: adopt
tiilliingiibylte: ineligiblity
ehscbikitaurdins: rinds
adrscothehrecoxs: chordates
njdodcieaoguvhrs: dice
torkbuhreciinmyy: cherub
oitaniasrmutiyni: sanitarium
leitnasaiidyrdto: entails
phaaycodclxigegl: eigg
cicopmlsuisvnose: clomps
aqiekynfsquthfsl: key
itjiucatnkaefnso: fake
aituwviiorayqtcd: ayr
irallcdaottuooem: call
ohlisyaecsjsrupt: easily
ilyiaeipfbsntukr: trunks
smieyorarcnergit: cratering
ohreppttormelleu: prophet
cofinssdfilnomag: flamingo
iisqsbaiotrorton: biota
bnsrlgintntyaapb: glint
ilayuiatwlcotglo: walcott
rmgloetxasuparbu: extol
onpeaoiozlticddn: colditz
enticjotboiafics: objectification
seminvqumyreretb: merry
noaavitlyadotisi: sodality
stinavheaestyhst: heaves
eoerstaeoghaqlmu: qualm
ialbrginznjoiguh: blaring
suitlqpitseraitk: quilts
phatnhsmrsdigbau: girds
ialaaodeiuztutnm: dieu
qntnneesotqhudui: quoth
joispcgdopohlbyy: pod
knimrqpeceivlkup: clive
orhsutnselseiueg: tuneless
gepcurilidnnqplw: periculi
ucktnsityaroeaib: stationery
semnuatdwliirsri: unmated
noezdrvscdpoeuwr: dozen
taiianmhvserpgue: purges
arinnitqicsagmre: grimaces
ohzikngdloqiwebr: king
ktegrnaarrnieced: arranger
anyaisioocsalecl: solace
diogrrhasftesfhh: forgathers
proppipyagitanrr: tarring
eeemrtpncnnykrht: temper
eeadorlxlnstkpat: loader
myeoluodlinovuls: loud
atotpzmjsrhenyro: henrys
aousyafaeistrcth: craftiest
ccereieiotpgzoel: zoe
nilnzagoeandtiai: antagonized
admiaidulotgltyc: loud
rsthasicptsopyhe: psychotherapists
auofontmrnsadrti: strand
eiapiksitneupscr: spunkiest
birmoplimsidsese: limps
sogeszuronlvaszj: suez
